11111111111111111111111111111111
1.B.........................B..1
1....G.......Q.................1
1.......................G......1
1..............................1
1.......1111111111111111.G.....1
1...Q...1...........T..1.......1
1.......1.R......C.....1.......1
1...G...1.....C.....C..1.......1
1.......1....C..C..C...1...Q...1
1.......1.C..C....C.C..1.......1
1...Q...1......11.C....1.......1
1..G....1.C.C..11C.....1.....G.1
1.......1C..C..C.C.C...1.......1
1...Q...1.C.C.C.C.C....1.......1
1.......1.C.C.C.C.C.C..1.....T.1
1..B....1C.C.C.C.C.C.C.1.......1
1.......1.C.C.C.C.C.C.C1.......1
1.......1111111111111111.......1
1..............................1
1............Q..............B..1
1..P..S.................Q......1
1..............................1
11111111111111111111111111111111