  111111111111111111111111111111111111111111111111
 1                                               1
  1  .111..C.......B.....S..................Q..  1  
 1   .111...........E................E.........  1
  1 .11...Q.11...................1.............  1
 1   ..............C.11.C...Q...111............  1
  1 ..C..1.C......C.11.C.......11111.....11111.  1
 1   ....111C...................111......C.111.  1
  1  ...11111....................1.....T..1111.  1
 1   ...111C....11111111.................C.111.  1
  1  ....1......1R..C.T1.................11111.  1
 1   ...........1..C.C.1.......................  1
  1  .......E...1CC.C.C1.......................  1
 1   .11111.....1C.C.C.1.........1......E......  1
  1  .1111......1.C.C.C1........111............  1
 1  .111P.......11111111.......11111...........  1
  1  .1111......................111............  1
 1   ..........M.................1.............  1
  1  Q...11111.................C.......E.......  1
 1   ...............C1...................C..11.  1
  1  ..............C111........1111111....1111.  1
 ..  C.1111.C.....11111.....Q...111111.....C11.. 1
  .  ...........Q..111..............E..........  1
 .   ...............1......................B...  1
  .                                              1
 1 11111111111111111111111111111111111111111111111
